2222222222222222222222222222
0000000000000222220000022000
0000000000000022200020022000
2222002220022000000220000200
0220002002000000002022200002
0000022002002002020020002222
2002200002022222220000020000
0022200200002000000000200000
0000002200020000002202000000
2220022000000002020000002220
0000220022002000000020022020
0200000002220200002000000022
0200002200000222222022200000
0002202200000000000020022000
2200000000200220002220000002
2211111111111221112221111112