0200202000000022222000202022
2002000002000000000000200002
2202002200022220202000200022
0000000022200020200020020220
0000020200000020022000000000
0022020002000220200222202020
2000020002022002020020000020
0000002002000002000200002002
0020000020222022020000222000
2000220000200000022022200020
0002002000222202220200000202
0220000200202000000002220002
0000000002200022200220022000
2000220022020000202000000200
0000000000000020022000000000
1111111111111111111111111111