00000000000
00000000000
01010111000
11000111000
11000111000
11000111000
11111111333
22222222333
22222222222
22222222222
22222222222