0000000000000000000000
0000000000000000000000
0011001100111111000000
1111110000001111110000
1111000000111111000000
1111000000111111000000
1111111111111111333333
2222222222222222333333
2222222222222222222222
2222222222222222222222
2222222222222222222222