2002222000002222000002222002
2000000000000000000000000002
2000220000000220000000220002
0000000000200000020000000000
2222222222220000222222222222
0000000000000000000000000000
0000000000000220000000000000
2000200000002222000000020002
2222220000022222200000222222
0000002000200000020002000000
0000000200000000000020000000
2000000002000000002000000002
2222222222200000022222222222
0000000000020000200000000000
0000000000000000000000000000
1111111111111111111111111111