0000000000000000000000000000
0000000000000000000000000000
0000002000200000002000000000
0000000002222222222200000000
0000200002000000000000200000
0000000002000000002222000000
0000000002002000020000000000
0000002002000200000000000000
0000000000200022000000000000
0000002000020000000022000002
0220002000002000000200200000
2000002000000222200000002200
2000002000000000000000000020
0000202000000000000000000000
3133333111311331133111133111
3333333333333333333333333333