0000000010000000000000000100
0000100000000000000010002010
0000000000000000000000000000
1000000000012100000000100001
0200000000000001000000000000
0000000100000000000000000000
0000000000000000100100020000
0000010000000030000010000000
0000020000000000000000000000
0000000000010000000000000002
0000010000000000001000000010
2000001000010002000000000000
0000010000000000000001100001
0000001000100000010000012000
1000000000000002100120000001
0000000000000000000000000000