0000000000000000000000000100
0001220000000130000001200000
0000000000000000000000000020
1000000000000000201000000001
0000000000000000000000000000
2020001000000200000000000202
0000000000000002000100000000
0101000200020000000020001010
0000000000000000020000000000
0210000000000000000000010020
2000021000000000000000200002
0000100000000220000000000100
0000000000000000000000000000
1202020202100000002020202020
1000100000000400000001010001
0000000000000000000000000000