0000000000000000000000000000
0000010000001000000000000100
0400000000000000000000000200
0000000000000000000000000000
2001000020000000000000000000
0000000000000100200000000000
0000000000000000001000001001
1000000000000100000000000001
1000000000000000000000000100
0000000000000000000000000000
1001000000000000000000000003
0000000000000001000000000000
2000000010000000000000000000
0000000000000000000002100000
0000000000000001000000000000
0000000000000000000000000000